LLLLLLLLLLLLLLLLLLLLLLLLLLLLLLLLLLLLLLLLLLLLLLLLLLLL
GGGGGGGGGGWGGGGGGGGGGGGGGGGGGGGGGGGGGGGGGGGGGGGGGGGG
GGGGGGGGGGWGGGGGGGGGGGGGGGGGGGGGGGGGGGGGGGGGGGGGWWGG
GGGGGGGGGGWGGGGGGGGGGGGGGWGGWGGGGGGGGGWGGGGGGGGGGGGG
GGGGGGGGGGWGGGGGGGGGGGGGGGGGGGGGGGGGHGGGGGGGGGGGGGGG
GGGGGGGGGGWGGGGGGGGGGGGGGGGGGGGGGGGGXGGGGGGGGGGGGGGG
GGGGGGGGGGWLLLLLLLLLLLLLLLLLLLGGGGGGGGWGGWWGGGGGGGGW
GGGGGGGGGGWGGGGGGGGGGGGGGGGGGGGGGGGGGGGGGGGGGGGGGGG3
GGGGGGGGGGWGGGXGGGGGGGGGGGGGGGGGGGGGGGGGGGGGGGGGWWGG
GGGGGGGGGGWGGGHGGGGGGGGGGGGGGGGGGGGGGGGGGGGGGGGGWWGG
GGGGGGGGGGWGGGGGGGGGGGGGGGGGGGGGGGGGGGGGGGGGGGGGGGGG
GGGGGGGGGGWLLLLLLGGGGGGGGGGGGGGGGGGGGGGGGGGGGGGGWWGG
GGGGGGGGGGGGGGGGGGGGGGGGGGGGGGGGGGGGGGGGGGGGGGGGGGGG
LLLLLLLLLLLLLLLLLLLLLLLLLLLLLLLLLLLLLLLLLLLLLLLLLLLL